NO ./assets/NO.xpm   
SO ./assets/SO.xpm
EA ./blabla
WE ./blabla

F 127,140,141
C 37,168,172

111111111111111111111111
100000000000000000000001
100000000000N00000000001
111111111111111111111111
