NO ./assets/NO.xpm
SO ./assets/SO.xpm
EA ./assets/EA.xpm
WE ./assets/WE.xpm

F 176,79,4
C 117,6,102

111111111111111111111111
1000000000110000000000001
1011000001110000000000001
1001000000000000000000001
11111111011000001110000001
1000000000110000011101111111
1110111111111011100000010001
11110111111111011101010010001
11000000110001011100000010001
100000000000000011000N0010001
10000000000000001101010010001
11000001110110111110111100011
11110111 1110101 101111010001
1111111111111111111111111111111
