111111111111111111111111111111
111111111000000000000000011111
100000000000000000111000100001
110000100000000000000000001111
111111111111111111111111111111
