NO ./blabla    
SO ./blabla
EA ./blabla
WE ./blabla

F 220,100,0
C 225,30,0

111111111111111111111111
1000000000110000000000001
1011000001110000000000001
1001000000000000000000001
11111111011000001110000000000001
100000000011000001110111111111111
1110111111111011100000010001
11110111111111011101010010001
11000000110001011100000010001
10000000000N00001100000010001
10000000000000001101010010001
1100000111010101111101111000111
11110111 1110101 101111010001
1111111111111111111111111111111
